111111111111111111111111111111
1E0C00001000000000000000000001
1111111010000000011111111100P1
100000101000000001000000010001
100C00100001010001011111010001
10000010010000010100001C010001
100000000111111101111011110001
100000100000000000000000010111
111111100000001011111000010001
100000000000001010C01000000001
100000000000001000001000011001
1000000C0000001111111000001111
100000000000000000000000000001
101100111000110011100011000111
100000000010000000001000000001
111111111111111111111111111111
