111111111111111111111111111111
1P0000000000000000000000000001
111111111111111111111111111101
100000000000000000000000000101
101111111111111111111111110101
101000000000000000000000010101
101011111111111111111111010101
1010100CCCCCCCCCCCCCC001010101
1010101CCCCCCCCCCCCCC1E1010101
101010111111111111111111010101
101010000000000000000000010101
101011111111111111111111110101
101000000000000000000000000101
101111111111111111111111111101
100000000000000000000000000001
111111111111111111111111111111